000000000000000000
00000000000000000000
00000000000000000000
00000000000000000000
00000000000000000000
00000000011110000000
00000000100001000000
00000001000000100000
00000000100000010000
00000000010000000000
00000000001000000000
00000000000100000000
00000000000010000000
00000000000001000000
00000000000001000000
00000111111110000000
00000000000000000000
00000000000000000000
00000000000000000000
00000000000000000000
00000000000000000000