10000000100000000000
00000000000000000000
00011111111111000000
00000000000000000000
00000000000000000000
00000000000000000000
00000000011111111000
00000000000000000000
00000000000000000000
00011111110000000000
00000000000000000000
00000000000000000000
00000001111111000000
00000000011111100000
00000000000000000000
00000000000000000000
00000000000000000000
01111111100000000000
00000000000000000000
00000001111111110000
00000000000000000000