10000000100000000000
00000000000000000000
00000000000000000000
00000000000000000000
00000000000000000000
00000000000000000000
00000000000000000000
00000000000000000000
00001000000010000000
00001000000010000000
00001000000010000000
00001000000010000000
00001000000010000000
00001000000010000000
00001000000010000000
00001000000010000000
00000111111100000000
00000000000000000000
00000000000000000000
00000000000000000000
00000000000000000000