10000000100000000000
00000000000000000000
00000000000000000000
00000000000000000000
00000000100000000000
00000000100000000000
00000000100000000000
00000000100000000000
00000000100000000000
00011111111111000000
00000000100000000000
00000000100000000000
00000000100000000000
00000000100000000000
00000000100000000000
00000000000000000000
00000000000000000000
00000000000000000000
00000000000000000000
00000000000000000000
00000000000000000000