10000000000000000000
01000000000000000000
00100000000000000000
00010000000000001000
00000000000000010000
00000000000000100000
00000000000001000000
00000000000000000000
00000000000000000000
00000000000000000000
00000000000000000000
00000000000000000000
00000000000000000000
00011100000010000000
00011100000001000000
00011100000000100000
00000000000000010000
00000000000000001000
00000000000000000100
00000000000000000010
00000000000000000001